################
##.....#.......#
#..###.#######.#
##.#.#.........#
#..#.###########
#.##...........#
#.....######.#.#
#######....#.#.#
#.....#.##.#...#
#.#..##.##.#..##
#.#...#....#...#
###.####.#####.#
#..............#
#.####.#########
#..............#
################